Question	Category
abbb Outstg issunces1	Unknown Intent
who is eaton's top competitors?	Specific Search
what banks are discussing Fintech development	Information Search
What's the latest on LUMA Energy?	General Search
what is gas chromatography?	Specific Search
Did any electric utilities discuss O&M reduction during Q3 2020 earnings calls?	General Search
crater	General Search
how do you fluidize a poweder?	Deep Search
how does the gun distance affect mottling	Deep Search
what was wescos q1 2021 sales growth?	Deep Search
What is revenue forecast for power transmission	Deep Search
can i fix different film build on one side of the body?	Specific Search
what is Shaping Air	Specific Search
HBAN FR Y-9LP	General Search
what is the best range of booth temperatura and humidity	Specific Search
What causes swelling	Specific Search
test logging with v1	Specific Search
what is the clearcoat mix ratio?	Specific Search
what did contractors say about the transmission market during q1 2021 earnings?	General Search
tell me about jp morgan	Information Search
what is the influence of high voltage?	Specific Search
What is the additive color mixture?	Specific Search
what is visc	Specific Search
us bank deposit growt	Specific Search
paint gun	General Search
what is a 2K isocyanate paint?	Specific Search
pseudoplastic fluid flow example	Specific Search
what did first horizon say about fintech	General Search
what is a fatty acid?	Specific Search
what is tristate saying about fintech	Specific Search
what is popping	Specific Search
Why does the top coat not stick?	Deep Search
verizon and 5g	General Search
What is L*a*b*?	Specific Search
how to improve sagging	Deep Search
ASTM	General Search
what is delta E	Specific Search
picture of a high rotation bell	Specific Search
What comments were made during Q3 2020 earnings calls related to transmission?	General Search
how to solve hologram marks	Deep Search
What is a blister?	Specific Search
how many banks in conneticut	Numerical Search
blisters on plastics	General Search
absorption spectra of uv absorbers	General Search
who runs refinish in north america	Specific Search
paste degradation	General Search
mottle	General Search
what is a run-out	Specific Search
Did Evergy see lower O&M costs in 2020?	Information Search
who are eaton's top competitors?	Specific Search
CNF	General Search
What problems can be caused by high film wetness?	Deep Search
brushability	General Search
pseudoplastic	General Search
what is a typicall bell speed?	Specific Search
wind energy production tax credit extension	Deep Search
what causes haze	Specific Search
which banks were responsible for the economic crisis of 2008	Specific Search
I have to much dirt in the base coat	Unknown Intent
how is the oil sector doing	General Search
What is dE*?	Specific Search
my net income	Numerical Search
What are banks saying about loan pricing and structure trends	General Search
what is long wave and short wave	Specific Search
what banks are discussing Fintech partnership	General Search
what products is abb going to release in 2021?	Specific Search
Has Quanta made any recent acquisitions?	General Search
What can be the cause of dirt?	Specific Search
what is a corrosion defect	Specific Search
what is ATOMIZER	Specific Search
what are contractors saying about the utility market in q1 2021?	Information Search
does bell speed impact appearance?	Specific Search
what is wescos utility outlook in 2021?	General Search
net interest margin at pnc	Information Search
What is rheology?	Specific Search
what is pop?	Specific Search
What are they saying about loan pricing and structure trends	General Search
what is biden ev plan	Deep Search
how does electron beam curing work?	Deep Search
what is ecoat	Specific Search
Which banks are contemplating being acquired	Specific Search
color	General Search
twingloss	General Search
run outs	General Search
calculation of dE	Specific Search
What is a pinhol	Specific Search
cymel	General Search
Top 20 fastest growing banks in the USA	Specific Search
Has Siemens recently completed any divestitures?	General Search
what's the biggest wealth management firm in the us	Ranking Search
Luwipal 072	General Search
what banks are discussing Fintech competition?/	Information Search
what did contractors say about COVID-19 during q1 2021 earnings?	Specific Search
what is the effect of bell rotation speed to color	Specific Search
pinhole on ed-coat	General Search
what is L,a,b value	Specific Search
We focus primarily on commercial lending	General Search
earnings	Specific Search
what banks are discussing Fintech competition?	Information Search
visible light wavelength	General Search
what is your purpose?	Unknown Intent
what is surface tension	Specific Search
siloxane crosslinking	General Search
who mentions ev infrastructure	General Search
how to avoid poor interior hiding	Deep Search
what are my peers saying about electric vehicles	Deep Search
what is the cause of crater	Specific Search
what was eaton's revenue in their electrical americas segment?	Information Search
pvd	General Search
gassing	General Search
how can I improve gloss?	Deep Search
how hard is talc?	Deep Search
what is  difference between Ecoat crater and Paint crater	Specific Search
when was sunnyside bancorp incorporated in the state of maryland	Specific Search
kratzer im Lack	Unknown Intent
revenue	Numerical Search
how to improve mottle?	Deep Search
Al aggregation	General Search
what is small holes	Specific Search
what is metamerism?	Specific Search
Which banks are contemplating being acquired?	Specific Search
what banks are talking about fintech competition	General Search
what was mastec's communication segment revenue growth %?	Information Search
What are the top oil fracking locations in the united states?	Ranking Search
how are you?	Unknown Intent
How are banks adopting DeFi?	Deep Search
how to increase solventborne basecoat resisitivity	Deep Search
What do I need to consider when adjusting the atomization parameter?	Specific Search
who is taking about consolidating bank branches?	Deep Search
pigment	General Search
dualcure	General Search
What does a bank's stress test peformance history look like, both currently and historically?	Specific Search
What is CIELAB?	Specific Search
does clearcoat thickness impact appearance?	Specific Search
Outstanding issuances of perpetual preferred stock	Numerical Search
how to stop sag?	Deep Search
How to include or exclude the impact caused by surface  phenomena?	Deep Search
what are l a b c h values	Specific Search
what is hiding	Specific Search
Which utilities mention reducing operation and maintenance budgets?	General Search
eggshells	Unknown Intent
Hydrolan	General Search
biden infrastructure bill	Deep Search
what is the surface area of black pigments?	Specific Search
What was Mastec's electric transmission segment revenue growth in 3Q20?	General Search
mapping	General Search
How to improve flake orientation	Deep Search
what bank worked on the most IPOs in 2021	Ranking Search
net charge offs at bank of america	Information Search
what is entergy's 3 year capital plan?	General Search
Capex spending for NextEra Energy	General Search
what is the deposit market of the community bank based in chester	Specific Search
Did Graybar announce a new Vice President Strategic Accounts?	Specific Search
spend volumes at american express	Information Search
How much is Evergy expected to invest as part of their STP?	Deep Search
what is the order rate for peers for q1 2021?	Deep Search
what banks are contemplating being acquired	General Search
which catalysts can be used	Specific Search
hubbell net income	Deep Search
clearcoat hardness	General Search
how to measure roughness	Deep Search
Did Wesco sell their Datacom business?	Specific Search
what is roughness	Specific Search
loss gloss	General Search
Where is the best pizza	Deep Search
How to solve bad levelling?	Deep Search
what is the melting point of iron?	Specific Search
cause of sagging	Specific Search
can i fix craters by sanding?	Specific Search
who is talking about crypto	Specific Search
What is a sandscratch	Specific Search
how is an emerging growth company indicated	General Search
circuit pressure	General Search
how to improve appearance	Deep Search
xylene a faster solvent as butyl acetate	General Search
How ti improve wettability	Deep Search
what solvents to use on waterborne paint	Specific Search
how fast is a bell speed?	Deep Search
what is electrocoat?	Specific Search
grinding resin	General Search
what is utility outlook in the us in 2021?	General Search
seidman	Specific Search
larry seidman	Specific Search
ワキ	Unknown Intent
E Coat bath recommended temperature	General Search
How to paint a car	Deep Search
How I can improve surface	Deep Search
bacteria	General Search
Which utilities are actively involved in renewable power generation projects?	General Search
spitting	General Search
what is the latest news on LUMA energy	Deep Search
How big is Chase bank	Specific Search
What banks are discussing FinTech partnerships?	General Search
Are banks investing in cryptocurrencies?	Specific Search
jpmorgan 10K	Information Search
What are banks saying about loan pricing and structure trend?	Ranking Search
settlements	General Search
what is spot repair	Specific Search
ecoat craters	General Search
ureclear chemistry	General Search
what is Spray booth	Specific Search
What are companies saying about capital spending plans?	Numerical Search
table of solubility parameters	Specific Search
speed of atomization air depending on air pressure	General Search
how to eliminate glomerates	Deep Search
is talc used in paint?	Specific Search
is competition causing loan spreads to widen or compress	Specific Search
how can I prevent craters?	Deep Search
what is a spass?	Specific Search
where can i find tier 1 capital ratio	Specific Search
Operation & Maintenance reductions	General Search
did the number of bank of hawaii branches grow or shrink in 2021?	Numerical Search
what caused sagging	Specific Search
How can a bank's liquidity health be measured from their balance sheet?	Deep Search
windshield adhesion	General Search
what are natural oils?	Specific Search
has abb recently launches any new products	General Search
what is the size of an electrocoat tank?	Specific Search
How can I detect sagging?	Deep Search
how does air atomization affect mottling?	Deep Search
what is a 2K paint?	Specific Search
how to fix pinsholes	Deep Search
What was Mastec's electric transmission segment revenue growth?	General Search
how many bank branches are there in nevada?	Numerical Search
what did citi say about crypto	Ranking Search
what are the largest US banks by assets	Ranking Search
cross hatch numbers	General Search
where is bitcoin trading	Specific Search
What COVID-19 impacts did Evergy see in 3Q 2020?	Specific Search
how hard is talc versus diamond?	Ranking Search
what is duke energy's segment structure?	General Search
what is color	Specific Search
what is the wholesale exposure risk for morgan stanley	Specific Search
What are considered liquid assets on a banks balance sheet?	Specific Search
how can I accelerate the flash off time	Deep Search
how can I prevent sags?	Deep Search
How is a bank's Solvency Ratio calculated?	Deep Search
causes for corrosion in a painted car	Specific Search
bell	General Search
glasurit 100	General Search
what causes craters	Specific Search
what are the different	Specific Search
smooth and  texttured bell edges	General Search
what is metamerism	Specific Search
What electric utilities are investing in system hardening?	Specific Search
butenediol structure	General Search
picture of a bell cup	Specific Search
what is a circulation system?	Specific Search
Which vendors service Wisconsin Energy with a supply agreement?	Specific Search
Why do we make adaptation to the color difference based on human visual system?	Deep Search
what is the influence of circuit pressures in metallic colors	Specific Search
how many branches does Chase have in New York	Numerical Search
How is the Q3 performance of the suncrest bank	Unknown Intent
are banks adopting decentralized finance?	Specific Search
How can I get more money	Information Search
corporate banking	Information Search
xylene	General Search
examples of polar groups?	Specific Search
CED	General Search
metamerism	General Search
What is a pinhole?	Specific Search
What are the different types of Nonperforming Loans (NPLs)?	Specific Search
What does mean DL*?	Specific Search
uv coatings	General Search
How to improve interior leveling	Deep Search
what is a polar group?	Specific Search
What banks are discussing FinTech partnerships	General Search
I want to improve flop dL	Unknown Intent
what are HALS	Specific Search
citibank earnings	Information Search
how big is chase bank	Information Search
poor coverage interior	General Search
paint shop	General Search
what is pinhols	Specific Search
tmdd	General Search
hoiw hard is diamond?	Specific Search
what is leveling	Specific Search
tribo-charging	General Search
what is a color standard?	Specific Search
what does jaime dimon say about crypto	Specific Search
what is PUD resin	Specific Search
what is a pigment	Specific Search
can i fix craters by sanding	Specific Search
pigment dyes	General Search
What comments were made during Q3 2020 earnings calls related to system hardening?	General Search
polishing marks	General Search
what does a bank do	Deep Search
what is the paint application temperature?	Specific Search
gassing of aluminum	General Search
What is the capital stress testing done by invictus in county bancorp	Ranking Search
what wavelength is blue light?	Specific Search
who is hban's ceo	Specific Search
core values of goldman sachs	General Search
how to control e-coat ph	Deep Search
HBAN regulatory	Information Search
what are contractors saying about the T&D market outlook for 2021?	Specific Search
bad leveling	General Search
how do pigments show color?	Deep Search
What are companies saying about capital spending plans? Or more broadly, the allocation of capital.	Information Search
what was eaton's  revenue growth percentage in q1 2021?	Information Search
banks with loan growth	General Search
What is ABB's north american revenue projection for 2021	Deep Search
what recent acquisitions has eaton made?	General Search
polyether	General Search
barium sulfate extenders	General Search
What are the additive/subtractive color mixture?	Specific Search
sugar creek financial	Information Search
tell me about jpmorgan	Deep Search
what is L*?	Specific Search
negative effect of high film thickness	General Search
NIM trends	General Search
What banks are discussing FinTech developments?	General Search
gloss	General Search
How to fix popping	Deep Search
How to remove dirt from paint	Deep Search
how to improve viscosity control	Deep Search
recent executive changes	General Search
how to fix adhesion	Deep Search
what are the drivers for utility capex spending?	General Search
what are different application types	Specific Search
what is eaton saying about their electrical americas segment performance?	Deep Search
what is color?	Specific Search
how about e-coat agglomerate	Deep Search
what is filtration?	Specific Search
what is pretreatment?	Specific Search
what is hiding?	Specific Search
what is cloudrunner	Specific Search
What is WASHINGTON BUSINESS BANK	Specific Search
autonomous vechiles	General Search
What does dE* mean?	Specific Search
what is defintiion of resin	Specific Search
hi dan	General Search
what are VOC	Specific Search
how much of bidens infrastructure plan is for power infrastructure?	Information Search
what is paint	Specific Search
what is a blister	Specific Search
what is the market outlook for 5G?	Deep Search
how to improve sanding marks	Deep Search
dyes	General Search
How many percentage of women are color ametropic?	Numerical Search
Who is the largest bank in connecticut?	Ranking Search
what are anti-coorosive pigments?	Specific Search
improving pearl wetting	Specific Search
what is adhesion	Specific Search
ssb bancorp earnings	Numerical Search
pinholes	General Search
bank cre guidance	General Search
DABCO	General Search
tell me about acquisitions	Information Search
what is the communications market growth outlook for 2021?	General Search
crater on electrodeposition	General Search
What is pihole	Specific Search
What is Valmont saying about the transmission market?	Deep Search
How does a Nonperforming Loan become a Reperforming Loan?	Deep Search
black	Unknown Intent
which banks merged in 2021	Specific Search
loan growth at bank of america	Information Search
What means DL*?	Specific Search
How much O&M cost reduction does Duke expect in 2020?	Deep Search
fluid tip	General Search
daotan	General Search
how to avoid overspray	Deep Search
door frame hiding	General Search
How can I improve the color harmony?	Deep Search
what was the leading bank for IPOs in 2019	Ranking Search
Has Eaton announced a price increase recently?	Specific Search
what investments is nextera making in renewable energy?	Specific Search
What causes bad flake orientation	Specific Search
spray guns	General Search
hban revenue	Information Search
What is the US EV forecast in 2021?	General Search
what is difference between basecoat and primer	Ranking Search
what is quanta's 2021 outlook?	Deep Search
bandicorp earnings	Specific Search
price of oil	Specific Search
What assest and expenses are considered interest bearing for a bank?	Specific Search
jpmorgan	Numerical Search
old national net income	Numerical Search
what banks have recently been acquired?	Specific Search
WHAT DID Gouverneur Bancorp ANNOUNCE	General Search
does zinc protect iron?	Specific Search
what is a defoamer?	Specific Search
what is hue?	Specific Search
how do you fluidize a powder?	Deep Search
hiding power	General Search
what is a 2k paint	Specific Search
corparate banking	Information Search
Newtonian flow	General Search
nozzle viscosity	General Search
what causes corrosion?	Specific Search
paint sag	General Search
tell me about stocks	Specific Search
autonomous	General Search
what is the proper target distance	Specific Search
what is the largest bank in US?	Specific Search
deposit betas	General Search
is hban considering acquisition	Specific Search
Hi! what is the viscosity of the water borne base coat?	Specific Search
what causes pop	Specific Search
What are electric utilities saying about green hydrogen?	General Search
edge protection	Deep Search
What was Duke Energy's O&M capex growth % from 2018 to 2019?	General Search
what interest rate assumptions are banks building into their earnings guidance?	Deep Search
oil price in permian basin	Information Search
What are banks saying about loan pricing and structure trends?	General Search
which banks are discussion fintech competition?	Specific Search
what is a corrosion defect in a car	Specific Search
elastomers	General Search
What are the drivers for electric transmission industry spending?	Specific Search
what are tiger stripes	Specific Search
what is eaton's 2021 outlook for the electrical americas segment?	Deep Search
electrodeposition	General Search
What was Duke Energy's T&D capex growth from 2018 to 2019?	Deep Search
what is paintshop	Specific Search
what does air flow in a spray booth look like?	Specific Search
ssb bancorp	Numerical Search
how many bank branches does chase bank have	Numerical Search
sodium salts	General Search
MMA	General Search
what is o Bel speed	Specific Search
rheology	General Search
is ozark considereing acquisition	Specific Search
How to describe the behavior of effect finishes?	Deep Search
trimethylolpropane	General Search
WHAT IS GRAININESS	Specific Search
What companies are discussing fintech competition?	General Search
crater on materials	General Search
Which banks are discussing FinTech competition	Specific Search
Did Evergy reduce O&M spend in Q3 2020?	Information Search
five star bancorp commercial lending	General Search
what causes tacky films?	Specific Search
VERSAILLES FINANCIAL CORPORATION Directors' fees	General Search
What causes spitting	Specific Search
what is a filler?	Specific Search
Other deductions from additional tier 1 capital for morgan stanley	Numerical Search
Type A crater	General Search
what are organic pigments?	Specific Search
How is a bank's efficiency ratio calculated?	Deep Search
what is paint?	Specific Search
definiton of gloss	Specific Search
300 bp improvement in ROTCE	Unknown Intent
what are contractors saying about the transmission market outlook for 2021?	Specific Search
hhow is gloss measured?	Deep Search
how to prevent crater	Specific Search
What causes hiding?	Specific Search
what is the electric utility outlook in 2021?	Ranking Search
Daotan resin	General Search
conductive primer	General Search
how many bank branches closes in us in 2020	Numerical Search
radical scavenging	General Search
What is ABB's 2021 end market outlook?	Deep Search
what is the market outlook for 5g	Deep Search
crietria for Ecoat crater	General Search
which are the top 20 fastest growing banks in the USA	Specific Search
laponite	General Search
what was mastec's communication segment revenue?	Information Search
chart of viscosity of paint and neutralization	Specific Search
how many branches does Citibank have in New York	Numerical Search
can I adjust my clearcoat with a slow solvent?	Specific Search
How is a bank's Loan-To-Deposit ratio calculated?	Deep Search
what do banks do	General Search
sodium sulfate	General Search
terpenes	General Search
what is the influence of application parameters	Specific Search
Can you recommend a matting agent?	Specific Search
what is a defoaming agent?	Specific Search
what is nextera's outlook for 2021?	Deep Search
chevron  air quality	General Search
how can I improve the hardness of a clearcoat	Deep Search
Which banks are considered to be part of the bulge bracket?	Specific Search
how many bonds did goldman sachs issue in 2019	Numerical Search
how to improve orange p	Deep Search
GMA	General Search
powder fluidizability	General Search
what's the largest bank in the US	Ranking Search
has abb recently launched any new products	General Search
what are the current mortage lending interests?	Information Search
what did contractors say about employees returning to work during q1 2021 earnings?	General Search
What was the total cost for Storm Isaias?	Specific Search
what is a defomaer?	Specific Search
What is Evergy's STP?	Information Search
What percentage of Duke Energy's planned future capex is related to T&D?	Ranking Search
low shear viscosity	General Search
what is flop index	Specific Search
how to fix pinholes	Deep Search
I have a low fiml build of ecoat in the interior what can I do?	Specific Search
which banks are contemplating acquisitions?	Specific Search
crater cause	General Search
what is the DIN method for solids?	Specific Search
how to improve vertical appearance	Deep Search
How much money is being invested in energy storage?	Numerical Search
what is viscosity	Specific Search
pop	Unknown Intent 
How to improve wettability	Deep Search
what is citigroup saying about fintech	Deep Search
what is the base painting	Specific Search
white spots	General Search
light stabilizers	General Search
How many branches does Chase bank have in New York	Numerical Search
what interest rate assumptions are banks building into their earnings guidance?	Specific Search
Which investor owned utilities provide natural gas to their customers?	Specific Search
e-coat	General Search
What is a runner	Specific Search
does fluid flow rate determine film thickness?	Specific Search
how is the oild sector doing	General Search
what is mottling	Specific Search
metamerismmetametamerism	Unknown Intent
what is Huntington Bancshares Inc income from bank subsidaries?	Deep Search
what is crater	Specific Search
what is colorimetry	Specific Search
what is oxidative hardening?	Specific Search
melamine　gloss	General Search
Crinkling	General Search
how to increase film build thickness	Deep Search
ALternative to byk mac	General Search
How to avoid crater	Deep Search
what is the best range of booth temperature and humidity	Specific Search
What is Eaton's 2021 growth outlook?	Deep Search
what is low gloss?	Specific Search
how you can identify a sinthetic fiber	Deep Search
what is 1,4-polyisoprene?	Specific Search
pentyl	General Search
what are my peers saying about the T&D market outlook for 2021?	Deep Search
alerus annual report	Information Search
How much of Evergy's capital plan is slated for T&D?	Information Search
does film build influence sag or drips?	Specific Search
how to improve pinholes	Specific Search
Mojabilidad	Unknown Intent
number of bank mergers in 2020	Numerical Search
deposit growth at catc	Information Search
what banks are discussing Fintech developments	General Search
what did contractors say about the transmission market revenue growth during q1 2021 earnings?	Deep Search
What are properties of alkyd resins mainly determined by?	Specific Search
color fading out	General Search
unrealized losses on investment securities available	General Search
who is talking about consolidating bank branches?	Specific Search
How do you feel?	Unknown Intent
Which U.S. bank was the originator of the highest mortgage loan volume in 2020?	Ranking Search
What articles discuss reduced utility budgets for Operation & Maintenance?	General Search
shadows	General Search
did the number of bank branches grow or shrink in 2021?	Information Search
example of a flow additive	Specific Search
surface profile roughness	Unknown Intent
how does hydrolosis work	Deep Search
how is the reaction between phosphate substance and e-coat	Deep Search
florida panel temperatures	General Search
what does a rotary atomizer look like?	Specific Search
mottling	General Search
How can I elinimate solvent pop?	Deep Search
what companies are discussing Fintech partnership?	Ranking Search
what is the definition of resin	Specific Search
what is thermal analysis?	Specific Search
what is small holes on substrate	Specific Search
What can I do against dirt on the car body?	Specific Search
commercial loans at wells fargo	Specific Search
which banks are discussing acquiring other banks?	Specific Search
What electric utilities are investing in electrical vehicle (EV) infrastructure	General Search
how to fix sag	Deep Search
what are seeds?	Specific Search
what is primer	Specific Search
can I adjust my clearcoat with solvent?	Specific Search
does salt accelerate corrosion?	Specific Search
what was the cause of widespread blackouts in Texas in april 2021	Specific Search
jp morgan stocks	Information Search
how to take crater samples	Deep Search
how to fix crater?	Deep Search
allowance for credit losses	Information Search
what are total projected electric utility distribution capex expenditures for 2022	Deep Search
viscosity and molecular weight equation	General Search
sunnyside income	Specific Search
UF drops	General Search
how can I improve paint leveling?	Deep Search
tell me about fintech	Information Search
how to take crater samples from car body	Deep Search
What is Duke Energy's planned T&D capital spending over the next 3 years?	General Search
what are the solids of an electrocoat bath?	Specific Search
what is electrocoat	Specific Search
net income	Numerical Search
what is rdsl	Specific Search
how often should check viscosity	Deep Search
definition of paint	Specific Search
what about sagging?	Specific Search
What is the cause of revenue increase	Deep Search
How are loans evaluated in TEB bancorp	Information Search
who mentions ev infrastructre	General Search
How is DeFi disrupting the banking industry?	Deep Search
what is 2021 T&D market growth outlook in the US?	General Search
what is entergy's capital plan?	Specific Search
what utilities announced revised capex plans during q1 2021 earnings calls?	Deep Search
micro popping	General Search
axp discount rate	Information Search
clouding	General Search
grid hardening bill with us senate	General Search search
what are my peers saying about the transmission market in q1 2021?	Information Search
How could I optimize the spray pattern for handling mottling?	Deep Search
how to identify type a crater	Specific Search
wetting of mica	General Search
Are any utilities considering constructing new nuclear generation plants?	Specific Search
atomization air and pressure	General Search
what were eaton's electrical segment sales in Q4 2020	Information Search
basf chemistry	General Search
Has WESCO made any divestitures recently?	Deep Search
At what rate is the transmission market expected to grow in 2021?	Deep Search
what percentage of forecasted capex is T&D	Deep Search
How to calculate the transfer efficiency in OEM coating application	Deep Search
what is the electric utility outlook in the us in 2021?	Ranking Search
evaporation rate: butyl versus xylene	Ranking Search
what is the impact of air flow on tiger stripes	Specific Search
What is pinhole	Specific Search
what was the us solar industry growth in 2020?	Deep Search
What is the additive/subtractive color mixture?	Specific Search
Aside from Credit Risk, what are the additional types of risk a bank is exposed to?	Specific Search
tips to acoid crater	General Search
what did first citibank say about interest rates	Deep Search
spass	General Search
who is talking about consolidating bank branches?	Deep Search
Which U.S. bank has the highest deposit market share?	Ranking Search
Bake chart	General Search
how can i improve lightness	Deep Search
What causes popping?	Specific Search
types of spray guns	General Search
What is HBAN saying about loan pricing and structure trend?	Ranking Search
history of ecoat	General Search
What does CenterPoint see as growth drivers?	Specific Search
W300 bake	General Search
color theory	General Search
What is dL*?	Specific Search
What causes loss of gloss	Specific Search
who is talking about consolidating bank branches	Deep Search
waterborne sedimentation	General Search
Hola	Unknown Intent
how to increase thickness	Deep Search
how to measure color?	Deep Search
how to improve ra	Deep Search
Does Terephthalic acid form an internal anhydride?	Specific Search
what is erichsen cupping ttest?	Specific Search
Stargloss	General Search
What is the cause of a low clearcoat film thickness?	Specific Search
what is pop	Specific Search
will lower film build reduce pop?	Specific Search
butyl evaporation rate	Specific Search
can slow solvent fix pop?	Specific Search
When does the production tax credit expire?	Specific Search
what is a crater	Specific Search
Which vendors service Wisconsin Energy with supply agreement?	Specific Search
what is short wave?	Specific Search
how to eliminate crater?	Deep Search
what was quantas revenue growth percentage in q1 2021?	Deep Search
net interest margin at USB	Information Search
can eddy current measure film thickness?	Specific Search
Tell me about the acorn project	Specific Search
how high is clearcoat gloss?	Deep Search
what is an e-coat clot	Specific Search
I want to improve dL flop	Unknown Intent
cracking	General Search
How are projected cash flows calculated for a bank through a discounted cashflow (DCF) model?	Deep Search
self drive cars	General Search
what is craters	Specific Search
Bank of America EPS 2021	Information Search
soft clearcoat	General Search
layer mix between CP1 and CP2	General Search
jpm revenue	Numerical Search
Which U.S. bank was the originator of the highest mortgage loan volume in 2020	Deep Search
what is the utility outlook in the us in 2021?	General Search
What can be countermeasures for pinhole?	Specific Search
what is chroma?	Specific Search
zeta	General Search
who discussed acquisitions last quarter?	Specific Search
How many branches does citibank have	Numerical Search
what is a resin	Specific Search
high speed rotary bell	General Search
what banks are discussing fintech competition	Information Search
do you filter paint?	Specific Search
What can I do to avoid blisters?	Specific Search
What was the cause of widespread Texas blackouts in April 2021	Specific Search
what are contractors saying about the transmission market in q1 2021?	Information Search
bleeding	General Search
ハジキ	Unknown Intent
when is the PTC phase out?	Deep Search
which companies are contemplating being acquired	Deep Search
Did Evergy see lower O&M cost in 2020?	Information Search
How is a bank's Capital Adequacy Ratio calculated?	Deep Search
Why relative sensitivity to spectral ranges vary from  person to person?	Deep Search
what is the influence of bell speed	Specific Search
how to fix paint pressure	Deep Search
sagging	General Search
what can be countermeasures for pinhole	Specific Search
siphon gun	General Search
surface modification of titanium dioxide	General Search
pinhole	General Search
what is the high voltage	Specific Search
where is Huntington bancshares headquarted?	Specific Search
what is an e-coat grume	Specific Search
what is 2021 utility market growth outlook in the US?	Deep Search
how to improve orange peel	Deep Search
did the number of bank branches grow or shrink in 2021?	Numerical Search
How do I avoid blisters during injection molding?	Deep Search
waterbonre	General Search
what's the biggest wealth management firm in the us by aum	Ranking Search
what is electrostatic application	Specific Search
pigment volume concentration	General Search
How does the gun distance affect popping?	Deep Search
How to evaluate achromatic colors?	Deep Search
how can I prevent pinholes?	Deep Search
How to fix dirt issues in Etl?	Deep Search
what are the main application parameters?	Specific Search
What are properties of alkyd resin mainly determined by?	Specific Search
what is eaton projecting for growth in 2022	Deep Search
which banks failed in 2008	Specific Search
what causes dirt	Specific Search
what are the different types of craters	Specific Search
which solvents are excempt	Specific Search
what did jp morgan say about fintech	General Search
what is a crater?	Specific Search
zeta potential	General Search
what is tip speed	Specific Search
are fatty acids reactive?	Specific Search
what is an e-coat lump	Specific Search
what was said about T&D market outlook during Q3 2020 earnings calls?	Information Search
dye	General Search
how to fix surface tension problems	Deep Search
How to fix specs issues in ed-coat?	Deep Search
1.2 fluid	General Search
electromagnetic	General Search
What strategies is prk developing around cryptocurrencies/distributed ledgers?	Specific Search
what is electro-osmosis?	Specific Search
blocked polyisocyanates	General Search
what is eaton saying about the utility market?	General Search
what are the most common defects in paint	Specific Search
what wavelength is red light?	Specific Search
How to fix dirt issues in Ecoat?	Deep Search
overspray defect	General Search
gross income	General Search
what does doi mean?	Specific Search
heartland	Information Search
what are the standard trichromatic values?	Specific Search
What interest rate assumptions is Huntington Bancshares Incorporated building into their earnings guidance?	Deep Search
what is a bank that does a lot of mortgage lending	Ranking Search
what is Wesco's utility market outlook in 2021?	General Search
surface tension	General Search
what is waterborne basecoat	Specific Search
hlb	General Search
chevron	General Search
What does the Herfindahl-Hirschman Index (HHI) represent?	Specific Search
chevron air quality	General Search
maclean product launch	General Search
settlements on paint cans	General Search
definition of resin	Specific Search
bank branches reduction in 2020	General Search
how much of bidens infrastructure plan is for energy infrastructure?	Information Search
how to measure dry film density	Deep Search
Ecoat recommended temperature	General Search
which banks are contemplating acquisition	Specific Search
improvement of pinholes	General Search
what percentage of forecasted US electric capex is T&D	Deep Search
what was eaton's sales growth percentage in q1 2021?	Information Search
TiO2	General Search
haze	General Search
What oil wells are in the permian basin?	Specific Search
uv	General Search
what is the thickness of electrocoat?	Specific Search
what did jpmorgan say about acquisitions	Ranking Search
what is UV curing of epoxy resin?	Specific Search
what causes mottling	Specific Search
how to check viscosity	Deep Search
what is surface energy?	Specific Search
what is quanta's 2021 electric power segment outlook?	Deep Search
what is sparkling	Specific Search
what causes bad appearance	Specific Search
what will form a crater?	Specific Search
what is filmbuild	Specific Search
How to make spot repair	Deep Search
paint	General Search
viscosity and molecular weight for the film formation process	General Search
flash off	General Search
what is eaton's 2022 growth outlook?	Deep Search
hello dan	Information Search
How are banks adopting defi	Information Search
total commercial loans at wells fargo	Information Search
what is basecoat?	Specific Search
styrene	General Search
what is the US distribution automation market forecast in 2021?	Ranking Search
transporte y distribucion segura	Unknown Intent
how to solve crater	Deep Search
How does the gun distance affect mottling?	Deep Search
what is colorimetry?	Specific Search
jpm personnel	Numerical Search
how to adjust spray pattern	Deep Search
what banks are contemplating acquisitions	General Search
cmc	General Search
alumaform product launch	General Search
what is the utility market outlook?	Ranking Search
boiling problem	Unknown Intent
paint problems	General Search
what is acetate butyrate used for	Specific Search
Who is taking about consolidating branches?	Deep Search
What strategies is park national bank developing around cryptocurrencies/distributed ledgers?	Specific Search
what is a bank that does a lot of mortgage lending	Deep Search
chev	Unknown Intent
how color retrieval works	Deep Search
butylacetate	General Search
What were Eaton's electrical segment sales in Q3 2020?	General Search
top oil producers in united states what bank worked on the most IPOs in 2021	General Search
Earning presentation	General Search
huntington bancshares ceo	Specific Search
How does the flow rate affect leveling?	Deep Search
how much renewable energy was added to the grid in 2020?	Numerical Search
how to fix pop	Deep Search
what is the market growth outlook for 5g	Deep Search
what is the US distribution automation market growth rate forecast?	Deep Search
uv curable clearcoats	General Search
What are Chase bank's subsidiaries	General Search
how to fix mottle	Deep Search
How does a bank's credit risk standing effect interest rates for their capital?	Deep Search
Did any electric utilities revise their capex forecasts in Q3 2020 compared to the prior quarter?	General Search
resin type automotive	General Search
what is surface tension?	Specific Search
what are current mortgage lending rates from citibank	Information Search
How are banks incorporating blockchain technology?	Deep Search
What causes over films?	Specific Search
how to imprve edge marking	Deep Search
ワキとは何ですか？	Unknown Intent
What line items are considered Tier-1 Capital?	Specific Search
what is atomization?	Specific Search
HBAN FR	Specific Search
What is OEM paint?	Specific Search
filtration	General Search
how thick is paint?	Deep Search
what is the target film thickness?	Specific Search
What percentage of us power supply comes from solar and wind sources	Ranking Search
what cause poor color m,atch?	Specific Search
safety transport and distribution	General Search
this year represents a third consecutive year of acceptable earnings	Specific Search
how to improve sagging?	Deep Search
do you speak german	Unknown Intent
What should I check in case of Mottling?	Specific Search
smooth and  textured bell edges	General Search
settling on a solvent borne basecoat	General Search
can I adjust my basecoat with a slow solvent?	Specific Search
what is the spectral density of standard light?	Specific Search
How to improve popping?	Deep Search
what color is chromium oxide?	Specific Search
aluminum effect pigment	General Search
How to fix dirt issues in clearcoat?	Deep Search
regions  net charge offs	Information Search
Has ABB recently launched any new products?	Specific Search
what was duke's transmission capital spend in 2018?	Deep Search
AFM	General Search
what is the peak temperature of a test panel in Florida?	Specific Search
Color strength	General Search
Are unsaturated polyester resins semi-finished products?	Specific Search
what are effect pigments	Specific Search
how much water is in waterborne paint?	Numerical Search
Which vendors service Wisconsin Energy with an integrated supply agreement?	Specific Search
what is the US distribution automation market forecast?	Deep Search
nonaccrual loans at mtb	Information Search
what's difference between popping and pinhole	Specific Search
How can a bank's credit risk be quantified?	Deep Search
scratch marks	General Search
What can I do if I have delamination?	Specific Search
what causes pinholes	Specific Search
which banks did the most M&A business in 2021	Ranking Search
what is windshield glass bonding?	Specific Search
layer cohesive failure	General Search
number of PNC branches	Numerical Search
how much of bidens infrastructure plan is for transmission infrastructure?	Information Search
the net income	Specific Search
has wesco recently made any divestitures?	Specific Search
does a green color absorb green light?	Specific Search
what strategies are banks developing around cryptocurrencies?	Specific Search
gassing of aluminum-contained waterborne basecoat	General Search
what fix bleeding	Specific Search
what is corona charging?	Specific Search
Who is the largest bank in connecticut	Deep Search
How do you paint?	Deep Search
E Coat recommended temperature	General Search
what states does duke energy serve?	Specific Search
what is the base painting\	Specific Search
fatty acids	General Search
What was Quanta's revenue growth percentage in Q3 2020?	General Search
what was pg&e's electric operating revenue YOY growth % in Q3 2020?	Information Search
what is GC?	Specific Search
pigment binder volume relation	General Search
layer mixing	General Search
How to evaluate chromatic colors?	Deep Search
what is the outlook for the transmission market in 2021?	Deep Search
us bank deposit growth	Specific Search
what is de audi	Specific Search
sanding marks	General Search
2022 guidance	General Search
What is the most important asset on a bank balance sheet?	Specific Search
what are appearance values?	Specific Search
spend volumes at axp	Information Search
viscosity of paint during film formation	General Search
most successful retail bank in Maine	Ranking Search
top oil producers in united states	Ranking Search
what are analysts saying about verizon and 5g	Specific Search
fdic	General Search
polyester structure	General Search
what are bank crypto plands	Specific Search
what was ABB's Q1 2021 sales growth?	Specific Search
what are anticorrosive pigments?	Specific Search
I have a low ph in the ecoat bath what can I d?	Specific Search
settlement	General Search
how to fix sagging	Deep Search
what is pinholes	Specific Search
pneumatic spray guns	General Search
What are electric transmission market drivers?	Specific Search
hydromic hydrolan	General Search
what is o Shaping Air	Specific Search
what are the process steps on colating lines?	Specific Search
what causes crater?	Specific Search
fix mottling	General Search
is there any m&a activity in oil	Specific Search
what is clouding	Specific Search
which banks are discussion fintech competition?	Specific Search
shear stress on paints	General Search
goldman sachs q3 net interest income	Information Search
acids and anhydrides	General Search
how do pigments show color	Deep Search
how to adjust the application parameter if the color is too light	Deep Search
how many customers does FPL serve?	Numerical Search
poor interior hiding	General Search
How to improve appearance?	Deep Search
citigroup earnings	Specific Search
how does air atomization affect mottling`?	Deep Search
which banks have branches closest to buffalo new york	Specific Search
What is Eaton's utility market growth rate forecast for 2021?	General Search
how to improve wetting	Deep Search
What was Eaton's Q4 2020 revenue outlook?	Information Search
what is sagging	Specific Search
what are the main application parameters	Specific Search
crater types	General Search
Slumping	General Search
what is an acrylic resin?	Specific Search
Paint theory	General Search
melamine	General Search
what is pigment volume concentration?	Specific Search
how many bank branches are there in nevada	Numerical Search
what is sag	Specific Search
is it raining?	Unknown Intent
help me	Unknown Intent
what was quanta's revenue growth percentage in q3 2020	Deep Search
what is a random error?	Specific Search
When was morgan stanley incorporated	Specific Search
Oven curve	General Search
does entergy plan to reduce O&M?	Deep Search
Who's talking about Basel IV?	Specific Search
What is C Three's market growth rate for transmission in 2021?	Deep Search
How to fix dirt issues in ed-coat?	Deep Search
color degradation	General Search
Why is M&T merging with Peoples?	Deep Search
What is a run-out?	Specific Search
Who mentioned earnings	Deep Search
What can I do to improve Sagging	Specific Search
Can you show me a fiber defect	Specific Search
interest rate sensitivity at cfg	Information Search
when does nextera expect employees to return to the office	Specific Search
who mentioned crypto	Deep Search
what is ecoat?	Specific Search
what are electric utilities sayng about green hydroGeneral Search	Information Search
what is rheology	Specific Search
tristate fintech	General Search
ecoat	General Search
is linseed oil in paint?	Specific Search
How to measure appearance by wavescan	Deep Search
when was Huntington Bancshares founded	Specific Search
storage modulus	General Search
how many online only retail banks in the US	Numerical Search
throw power	General Search
how many linkedin followers does ABB have?	Numerical Search
what is a ball mill?	Specific Search
What strategies are banks developing around cryptocurrencies/distributed ledgers?	Specific Search
company net income	Specific Search
is a crater a pinhole?	Specific Search
what are the different types of application	Specific Search
how to measure surface tension	Deep Search
what is used in clearcoat	Specific Search
allowence for credit losses	Specific Search
what is o o Spray booth	Specific Search
spotting	General Search
capital expenditures for southern company	General Search
corporate planning	Information Search
is ozark considering acquisition	Deep Search
what is a bell applicator?	Specific Search
non-Newtonian flow	General Search
Why do I see blisters?	Deep Search
Which banks are considered to be part of the bulge bracket?	Specific Search
I see whitening in the clearcoat	Unknown Intent
Recent Gridliance news?	General Search
directors of signature bank	Specific Search
How to fix crater issues?	Deep Search
color match	General Search
clouds	General Search
ssb bancorp From parent holding company	Numerical Search
Which banks are talking about fintech competition	Deep Search
VERSAILLES FINANCIAL CORPORATION	Information Search
what happens with high bath conductivity?	Specific Search
What is Eversource's capital plan?	Information Search
What is the Rheology control agent in waterborne basecoat	Specific Search
which banks ipo'd in 2021?	Specific Search
how to improve edge marking	Deep Search
how much did entergy spend on storm related expenses in February 2021?	Numerical Search
what is the DIN method for solids	Specific Search
what is an e-coat dirt	Specific Search
improvement packaging marks	General Search
how is the 10 yr treasury today	Unknown Intent
tell me about paint	General Search
american express discount rate	Information Search
abbb Outstanding issuances of perpetual preferred stock	Unknown Intent
coating foils	General Search
how can i prevent orange peel?	Deep Search
what is resin	Specific Search
What is RDOF?	Specific Search
how to fix crater on substrate	Deep Search
Puerto Rico Electric Power Authority news releases	Information Search
How to prevent sagging?	Deep Search
what is VOC	Specific Search
what is the capital expenditure forecast for Southern Company	Deep Search
voc	General Search
what did utilities say about capex plans during q1 2021?	Information Search
Pinhol	General Search
aliphthalic hydrocarbons	General Search
PVC	General Search
what color is iron oxide?	Specific Search
what's the biggest bank in the US	Ranking Search
who are you	Unknown Intent
xylene and haps	General Search
How much is spent annually on electric substation construction?	Numerical Search
jpm earnings	Numerical Search
what is shipping air	Specific Search
imino	General Search
where was Huntington Bancshares founded	Specific Search
what is barium sulfate?	Specific Search
what is a pigment?	Specific Search
E Coat bath temperature	General Search
M&A activity in oil	Specific Search
how to increase filmbuild thickness	Deep Search
How much do electric utilities spend on the construction of one mile of transmission line?	Numerical Search
what banks are discussing fintech	Information Search
What might happen if I increase the flow rate?	Specific Search
what is a piston pump?	Specific Search
what are hubbell's 2021 expectations for T&D market growth?	Deep Search
Hydromic	General Search
bancorp net income	Specific Search
layer mix	General Search
dilatent	General Search
I have run-outs what can I do?	Specific Search
basecoat primer adhesion	General Search
what is imnportant for adhesion?	Specific Search
muensel	General Search
how to increase resisitivity	Deep Search
what is the FLOWRATE	Specific Search
Why do I see blisters in the coating?	Deep Search
How can you determine the amount of Risk-Weighted assets held by a bank?	Deep Search
what is a pinhole	Specific Search
bank branches reduction in 2020	Numerical Search
door frame coverage	General Search
what is the equation for density?	Specific Search
how are interest rate reductions going to impact banks?	Deep Search
what was PG&E's wildfire mitigation plan spending from 2017-2020?	Information Search
What COVID-19 impacts were discussed on Entergy's 3Q20 earnings call?	General Search
What is the recommended application electric resistance range for OEM coating ESTA spray	Specific Search
base coats sags root cause	General Search
what is chroma	Specific Search
hot to fix motlling	Specific Search
cause of telegraphing	Specific Search
How much stoving temperatures does phenolic resins require?	Numerical Search
What are the kind of craters	Specific Search
Have there been any recent price increases announced in the electric utility industry?	Deep Search
who is huntington bancshare's ceo?	Specific Search
acquisition plans	General Search
lakh bug	General Search
what did jpmorgan say about fintech	Ranking Search
munsel	General Search
what is the utility market outlook in 2021?	Ranking Search
what did contractors say about the T&D market during q1 2021 earnings?	Deep Search
what causes pinhole	Specific Search
types of crater	General Search
who missed revenue last quarter?	Specific Search
what interest rate assumptions are banks building into their earnings guidance	Deep Search
we have lines in the water	General Search
What the heat resistance do silicone resins have?	Specific Search
did centerpoint comment about O&M management during their Q1 2021 earnings call?	Deep Search
what were eatons electrical segment sales in q4 2020?	Information Search
mastec q4 2020 earnings call slides	General Search
how to measure color	Deep Search
how is the 10 yr treasury today	Specific Search
what is the outlook for the us transmission market in 2021?	Deep Search
what is the adequate target distance	Specific Search
what was aep's EPS for Q3 2020?	Information Search
west coast banks	General Search
How to measure the spectral distribution?	Deep Search
will solid content of the material influence the film build?	Specific Search
What causes Mottling?	Specific Search
e-coat agglomerate	General Search
basecoat adhesion	General Search
what is quanta's 2021 industry outlook?	Deep Search
which banks are discussing crypto	Specific Search
what are analysts saying about verizon and 5g	Specific Search
Where are Chase bank's subsidiaries	Information Search
ratio lw and sw	General Search
What can i do if facing craters?	Specific Search
compatibility	General Search
definition of CIE color space	Specific Search
what do people think about crypto	Ranking Search
acetic acid structure	General Search
what are the largest banks in the US	Ranking Search
what is Prosim	Specific Search
what is an e-coat pinhole	Specific Search
Crater prenvention	General Search
how does viscosity correlate to molecular weight?	Deep Search
what is an agglomerate	Specific Search
Why relative sensitivity to spectral ranges varies from  person to person?	Deep Search
types of resins	General Search
How is a bank's Net Interest Income calculated?	Deep Search
wind generation	General Search
carbodiamide	General Search
how do i stabalize ph	Deep Search
how can I prevent fisheyes?	Deep Search
raygloss	General Search
what is a pyknometer	Specific Search
cross hatch rating	General Search
color care	General Search
what is Huntington Bancshares Inc FFIEC 101	Ranking Search
adhesion causes	Specific Search
what is a basecoat	Specific Search
what causes sagging?	Specific Search
Exton, Pennsylvania Branch	General Search
surface tension too low	General Search
Investments in own tier 2 capital instruments for Morgan Stanley	General Search
What oil well are in the permian basin?	Specific Search
tristate	General Search
picture of a high speed bell	Specific Search
how many hotsticks does hastings sell every year	Numerical Search
appearance	General Search
What are the top oil fracking locations in the united states	General Search
how you can identify an organic fiber	Deep Search
what is film thickness	Specific Search
what transmission projects are going on at AEP?	Specific Search
what are bank loan growth expectations	Specific Search
How many branches does morgan stanley have	Numerical Search
PREPA news releases	Information Search
how are you	Unknown Intent
who is reporting earnings next week?	Specific Search
who is us director of sales for ecr	Specific Search
hban net income	General Search
what is pigment	Specific Search
How to avoid overspray in the paint?	Deep Search
what is BNPL	Specific Search
What is the significance of a bank's capital tiers, such as tier 1 and tier 2 capital?	Specific Search
8QUHDOL]HGORVVHVRQLQYHVWPHQWVHFXULWLHVDYDLODEOHIRUVDOH	Unknown Intent
when does Apples next Quarter start?	Specific Search
fluid tip size	General Search
how to increase transfer efficiency	Deep Search
how many branches does citibank have in New york?	Numerical Search
viscsoity of paint during film formation	General Search
what is the viscosity of the paint during film formation?	Specific Search
what is the cause of pop	Specific Search
What companies are discussing fintech competition	General Search
when does Apple next Quarter start?	Specific Search
Why is shareholder equity an important metric for assessing leverage and loan risk?	Deep Search
fon	Unknown Intent
crypto strategy	General Search
who acquired banks in 2021?	Specific Search
what causes adhesion failure	Specific Search
how to prevent sagging	Deep Search
what did jpmorgan say about pension plans	Ranking Search
How to improve verticle appearance?	Deep Search
what is a ball mill	Specific Search
what is dry film density?	Specific Search
what was said about crypto	Specific Search
sprayability	General Search
What would conversion of styrene result in?	Specific Search
inside ownership at sbny	Specific Search
what is the film thickness of electrocoat?	Specific Search
what are effect pigments?	Specific Search
DLVO theory	Specific Search
what does tmdd do	Specific Search
ureclear	General Search
I have a low film build of ecoat in the interior what can I do?	Specific Search
Is xylene a faster solvent as butyl acetate?	Ranking Search
what is tristate saying about acquisition	Specific Search
Loan Rollforward	Numerical Search
What storms was Duke Energy impacted by in 2018?	Specific Search
definition of mottling	Specific Search
what is the outlook for the electric utility market in the US?	Deep Search
Funding secured by level 2A liquid assets	General Search
What is sagging?	Specific Search
what is Huntington Bancshares Inc Factsheet	Ranking Search
how to fix sagging?	Deep Search
ss	General Search
what types of paint resin are there	Specific Search
what is SW and LW	Specific Search
How does a Bank make money through assets and liabilities, such as loans and deposits?	Deep Search
what was PG&E's capex spend in Q1 2020?	Information Search
how to get rid of soft paint	Deep Search
How to use a Byk-mac i?	Deep Search
what is a a typical bell diameter?	Specific Search
velocity of atomization air as a funtion of air pressure	General Search
Huntington bancshares inc ffiec 101	Deep Search
what is a bell?	Specific Search
bnpl	Information Search
what does a pneumatic spray gun look like?	Specific Search
what projects are part of the $8B DOE funding for transmission projects?	Ranking Search
what is long wave?	Specific Search
what is an attritor mill?	Specific Search
How to fix mottling on the hood?	Deep Search
How many branches does Chase bank have in Connecticut	Numerical Search
what causes small holes	Specific Search
Drying speed	General Search
What banks are discussing fintech competition/partnerships/developments?	Information Search
which banks are discussing mergers	Specific Search
where are plastic parts used on automobiles?	Specific Search
five star bancorp Loan Portfolio Composition	Specific Search
how to improve mottle	Deep Search
which banks acquired companies in 2021?	Specific Search
polyether structure	General Search
acquisitions	General Search
viscsoity of paint during film formaiton	General Search
Is xylene a faster solvent as btyl acetate?	Ranking Search
what is an e-coat agglomerate	Specific Search
what causes orange peel?	Specific Search
what is the price of oil	General Search
did evergy reduce O&M in Q4 2020?	Information Search
regions bank net charge offs	Information Search
how are audi tolerances calculated	Specific Search
what is eaton projecting for growth for 2022	Deep Search
how to decrease film build	Deep Search
black volkswagen	General Search
who mentioned cryptocurrency	Deep Search
banks with loan growth	General Search
hello	Unknown Intent
what did jp morgan say about earnings	General Search
jp morgan personnel	Deep Search
what did jpm say about earnings	General Search
improvement hardness of basecoats	General Search
which banks are contemplating acquisitions	Specific Search
What are Chase bank's subsidiaries	Information Search
what are  fisheyes?	Specific Search
what is OG&E's capex plan?	Deep Search
Which U.S. bank has the highest deposit market share	Deep Search
how to fix crater issues	Deep Search
Does Biden's infrastructure bill include electric grid investment?	General Search
what is de cmc	Specific Search
what is de*	Specific Search
what is paint leveling?	Specific Search
what is a slow solvent?	Specific Search
what is clearcoat?	Specific Search
viscosity and molecular weigh tequation	General Search
what is the outlook for the electric utility market?	Deep Search
what causes bleeding	Specific Search
what states does AEP serve?	Deep Search
how are fed interest rate reductions going to impact banks?	Deep Search
acetone	General Search
what is a solvent	Specific Search
finance	General Search
what is methamerism	Specific Search
net incomes	Numerical Search
what sources of fibers exist	Specific Search
How to avoid seeds in the paint?	Deep Search
tinting power	General Search
what are bank crypto plans	Specific Search
What did citigroup say about fintech	General Search
how to fix mottling	Specific Search
anodic electrocoat	General Search
what causes small holes in substrate	Specific Search
smooth and  textured rims of bell cups	General Search
How to improve haze	Deep Search
what is the visible light range in nm?	Specific Search
What causes voltage failure	Specific Search
Processing copper	General Search
How can avoid popping in the clearcoat	Deep Search
how to find a color variant	Deep Search
what causes crater	Specific Search
what is sag?	Specific Search
s xylene a faster solvent as butyl acetate?	Specific Search
bubble viscosity	General Search
yellowing after heat ageing	General Search
which banks failed in 2008	Deep Search
smooth and serrrated bell picture	General Search
What did my competition say about green hydroGeneral Search	Ranking Search
what banks are discussing Fintech partnership?	General Search
Which companies are discussing fintech?	Deep Search
does clearcoat thickness impact pop?	Specific Search
what did citibank say about fintech	Ranking Search
What strategies are banks developing around cryptocurrencies	Specific Search
what did first citibank say about fintech	General Search
why do metals corrode	Deep Search
what is the difference between a pop and a pinhole?	Ranking Search
what is citigroup saying about crypto	Deep Search
causes for corrosion in a painted body	Specific Search
how is a banks solvency ratio calculated?	Information Search
what is eaton's 2022 growth outlook?	Deep Search
loss of gloss	General Search
is the number of bank branches for huntington bancshares increasing or decreasing?	Numerical Search
Who are the GSIBS?	Specific Search
how you can identify a natural fiber	Deep Search
What is Eaton's organic growth forecast through 2025?	Deep Search
Where are Chase bank's subsidiaries	Specific Search
How much is Evergy expected to invest as part of their Sustainable Transformation Plan (STP)	Deep Search
How can I improve flake orientation	Deep Search
citigroup revenue	Information Search
Oncor's summer preparedness program	General Search
what does a bell applicator look like?	Specific Search
what did jp morgan say about crypto	Information Search
What valuation multiples and metrics are most important when performing comparable analysis across banks?	Specific Search
how to fix crater	Deep Search